1111111111111111111111111
10C0000000C0100010C100C01
1000100001000100000001001
1P00000C010000000100000E1
10010000100C100C10001C011
1000100001000100010001001
1C00100001000100010C01001
100010000100C100010001001
1111111111111111111111111