11111111111
1000C0000E1
1P000000A01
11111111111