11111111111111
10001111C00001
1001P000C00001
10011E00000001111
11111111111111