11111111111111111111
10C0000000C0100010C1
10001000010001000001
1P00000C010000000101
10010000100C100C10E1
10001000010001000101
1C001000010001000101
100010000100C1000101
11111111111111111111
