111111111111111111111111111111
10P010000000010000000100100001
10001000010001000100010000E001
100010000100C10001000100111111
100010000100010001000100000001
100010000100010001000100011001
1000000C010000000100000001C101
111111111111111111111111111111